Crystal Castle
####################
#                  #
#                  #
#                  #
#                  #
#                  #
#    o             #
#                  #
#                  #
####################