Haunted Mansion
########################################
#                                      #
#                                      #
#    #############################     #
#    #                           #     #
#    #                           #     #
#    #                           #     #
#    #                           #     #
#    #             ############# #     #
#    #             #           # #     #
#    #             #           # #     #
#    #             #           # #     #
#    #             #           # #     #
#    #             #           # #     #
#    #             #           # #     #
#    #             #           # #     #
#    #             #    o      # #     #
#    #             #           # #     #
#    #             #           # #     #
#    ###############           # #     #
#                               #      #
#                               #      #
########################################